TR TR TR TR TR TR TR TR TR TR TR TR TR TR TR TR TR TR TR
TR RO RO RO TR TR GR GR GR GR GR GR GR GR GR GR RO RO RO
TR RO RO TR TR GR GR SO GR GR GR GR GR GR GR GR GR RO RO
TR RO RO GR GR GR GR GR GR GR GR GR GR GR GR GR GR GR RO
TR RO GR GR GR GR GR GR GR GR GR GR GR RO GR GR GR RO RO
TR GR GR GR GR GR GR TR TR GR GR GR GR GR GR GR GR RO RO
TR RO GR GR GR GR GR RO GR GR GR GR GR GR GR GR GR GR TR
TR GR GR GR GR TR TR TR GR GR GR GR GR GR GR GR GR GR TR
TR GR GR GR GR GR GR GR GR GR GR GR GR GR TR GR GR GR TR
TR GR GR GR GR GR GR GR GR GR RO GR GR GR GR GR GR GR TR
TR GR GR GR GR GR GR GR GR GR GR GR GR GR GR GR GR GR TR
TR GR GR GR GR TR GR GR GR GR GR GR GR GR GR RO GR GR TR
TR GR GR GR GR GR GR GR GR GR GR GR GR GR GR GR GR GR RO
TR GR GR GR GR GR GR GR GR GR GR GR GR GR GR GR GR GR RO
TR TR GR GR GR GR GR TR GR GR GR GR RO GR GR GR GR GR RO
TR GR GR GR GR GR GR GR GR GR GR GR GR GR GR GR GR GR RO
TR GR GR GR GR GR GR GR GR GR GR GR GR GR GR GR GR GR RO
TR RO GR GR GR GR GR GR GR GR GR GR GR GR GR GR GR GR RO
TR RO GR GR GR GR GR GR GR GR GR GR GR GR GR GR GR GR RO
TR RO RO GR GR GR GR GR GR GR SH GR GR GR SH GR GR GR RO
TR RO RO RO RO GR GR GR GR GR GR GR GY GR GR GR GR GR RO
TR RO RO RO RO RO GR GR GR GR SH GR GR GR SH GR GR GR TR
TR RO RO RO RO RO RO GR GR GR GR GR GR GR GR GR GR GR TR
TR TR TR TR TR TR TR TR TR TR TR TR TR TR TR TR TR TR TR